0-01 0-01 0-01 0-01 0-01 0-03 0-01 0-01 0-01 0-01 0-01 0-01 0-01 0-01 0-01 0-01
0-01 0-01 0-01 0-01 0-01 0-01 0-01 0-01 0-01 0-01 0-04 0-01 0-01 0-01 0-01 0-01
0-01 0-01 0-02 0-01 0-01 0-01 0-20 0-16 0-21 0-01 0-01 0-01 0-01 0-01 0-01 0-01
0-01 0-01 0-01 0-01 0-01 0-20 0-27 0-00 0-26 0-21 0-01 0-01 0-01 0-01 0-02 0-01
0-01 0-01 0-01 0-01 0-01 0-17 0-00 0-00 0-08 0-18 0-01 0-01 0-01 0-01 0-01 0-01
0-01 0-04 0-01 0-01 0-01 0-17 0-00 0-00 0-00 0-36 0-11 0-11 0-11 0-11 0-11 0-11
0-01 0-01 0-01 0-01 0-01 0-17 0-00 0-00 0-00 0-18 0-01 0-01 0-01 0-01 0-01 0-01
0-01 0-01 0-01 0-01 0-01 0-22 0-25 0-00 0-24 0-23 0-01 0-07 0-01 0-01 0-04 0-01
0-01 0-01 0-01 0-02 0-01 0-01 0-17 0-00 0-18 0-01 0-01 0-01 0-01 0-01 0-01 0-01
0-01 0-01 0-01 0-01 0-01 0-01 0-17 0-00 0-18 0-01 0-01 0-01 0-01 0-01 0-01 0-01
0-03 0-01 0-01 0-01 0-01 0-01 0-17 0-00 0-18 0-04 0-01 0-01 0-02 0-01 0-01 0-01
0-01 0-01 0-01 0-01 0-01 0-01 0-17 0-00 0-18 0-01 0-01 0-01 0-01 0-01 0-01 0-01