01 01 01 01 01 03 01 01 01 01 01 01 01 01 01 01
01 01 01 01 01 01 01 01 01 01 04 01 01 01 01 01
01 01 02 01 01 01 20 16 21 01 01 01 01 01 01 01
01 01 01 01 01 20 27 00 26 21 01 01 01 01 02 01
01 01 01 01 01 17 00 00 08 18 01 01 01 01 01 01
01 04 01 01 01 17 00 00 00 36 11 11 11 11 11 11
01 01 01 01 01 17 00 00 00 18 01 01 01 01 01 01
01 01 01 01 01 22 25 00 24 23 01 07 01 01 04 01
01 01 01 02 01 01 17 00 18 01 01 01 01 01 01 01
01 01 01 01 01 01 17 00 18 01 01 01 01 01 01 01
03 01 01 01 01 01 17 00 18 04 01 01 02 01 01 01
01 01 01 01 01 01 17 00 18 01 01 01 01 01 01 01